|--------------|
|.Gx|...|..|...|
|..-|....@.....|
|.G....|...||..|
|......|...G...|
|--------------|