|--------------|
|xG.|......|...|
|..-|....@.....|
|.G....|...|...|
|......|...G...|
|--------------|