|--------|
|.G.|....|
|..-|.@..|
|.G......|
|--------|