|------------------------------------------------|
|....|......|.....................|.....|......|.|
|..-...----..-....-....-....-....-..--...----...-|
|.|...............-|....|....|....|.........|....|
|.|.-...----..-..-..--..--..--..--..--..----...-.|
|.|...|......|.....|................@..|...|.....|
|.---..----..--...-.--................|...----..-|
|......|...........|...................|.........|
|------------------------------------------------|